Test that resolving minmax function with min-content on grid items works properly.

XXX XXX XXX
PASS
XXXXX XXXXX XXXXX XXXXX
PASS
XX XX XX XX XX XX
PASS
XX XX XX XX XX XX
PASS
XXXXX XXXXX XXXXX XXXXX
PASS
XXX XXX XXX
PASS
XXXXX XXXXX XXXXX XXXXX
PASS
XX XX XX XX XX XX
PASS
XXXXX XXXXX XXXXX XXXXX
PASS
XX XX XX XX XX XX
PASS
