Test that resolving spanning minmax tracks on grid items works properly.

XXX XXX XXX
PASS
XX XX XX XX XX XX
PASS
XXXXX
PASS
XXX XXX XXX
PASS
XXX XXX XXX
PASS
XX XX XX XX XX XX
PASS
XXXXX
PASS
XXXXX
PASS
XXX XXX XXX
PASS
XXX XXX XXX
PASS
XX XX XX
PASS
XX XX XX
PASS
XXXXX XXXXX XXXXX
PASS
XXXXX XXXXX XXXXX
PASS
XXX XXX XXX
PASS
XXXXX XXXXX XXXXX
PASS
XXX XXX XXX
PASS
XXXXX XXXXX XXXXX
PASS
XXX XXX XXX
PASS
XXXXX XXXXX XXXXX
PASS
XXXXXXXXXXXX XXXXXXXXXXXX
PASS
XXXXXXXXXXXX XXXXXXXXXXXX
PASS
XXXXXXXXXXXX XXXXXXXXXXXX
PASS
XXXXXXXXXXXX XXXXXXXXXXXX
PASS
XXXXXXXXXXXX XXXXXXXXXXXX
PASS
XXXXXXXXXXXX XXXXXXXXXXXX
PASS
