Test that resolving minmax function with max-content on grid items works properly.

XX XX XX
PASS
XX XX XX
PASS
XX XX XX XX XX
PASS
XX XX XX XX XX XX XX XX
PASS
XX XX XX XX XX XX XX XX
PASS
XX XX XX
PASS
XX XX XX XX XX XX XX XX
PASS
XX XX XX XX XX XX XX XX
PASS
XX
PASS
XX XX XX
PASS
XX XX XX XX XX
PASS
XX XX XX XX XX
PASS
XX XX XX
PASS
XX XX XX XX XX
PASS
XX XX XX XX XX
PASS
